O,T,O,O,O,O,T,O,T,O,O
O,O,O,O,O,O,O,O,O,O,O
T,O,O,O,O,O,O,O,O,O,T
T,O,O,O,O,O,O,O,O,O,O
T,O,T,O,T,O,O,T,O,O,T
O,O,O,O,O,O,O,O,O,O,O
O,O,O,O,O,O,O,O,O,O,O
O,O,O,O,O,O,O,O,O,O,O
T,O,O,O,T,O,O,O,O,O,O
O,O,O,O,O,O,O,T,O,O,O
O,T,O,T,O,T,O,O,O,O,O
