T,O,O,T,O
O,O,O,O,T
O,O,T,O,O
T,O,O,O,T
O,O,O,O,T